{
  "width": 24,
  "height": 18,
  "tilewidth": 32,
  "tileheight": 32,
  "layers": [
    {
      "name": "floor",
      "type": "tiles",
      "data": [
        0, 0, 0, 0, 0, 0, 0, 0, 0, 0, 0, 0, 0, 0, 0, 0, 0, 0, 0, 0, 0, 0, 0, 0,
        0, 1, 2, 1, 2, 1, 47, 1, 2, 1, 48, 1, 2, 1, 2, 47, 1, 2, 1, 2, 1, 48, 1, 0,
        0, 2, 1, 47, 1, 2, 1, 2, 1, 48, 1, 2, 1, 47, 1, 2, 1, 48, 1, 2, 47, 1, 2, 0,
        0, 1, 48, 1, 2, 1, 2, 47, 2, 1, 2, 1, 48, 1, 2, 1, 2, 1, 2, 1, 2, 1, 1, 0,
        0, 2, 1, 2, 1, 47, 1, 2, 1, 2, 1, 47, 1, 2, 48, 1, 2, 1, 47, 1, 2, 48, 2, 0,
        0, 1, 2, 47, 2, 1, 48, 1, 2, 1, 48, 1, 2, 47, 1, 2, 1, 2, 1, 2, 1, 2, 1, 0,
        0, 48, 1, 2, 1, 2, 1, 47, 1, 2, 1, 2, 1, 2, 1, 48, 47, 1, 2, 1, 47, 1, 48, 0,
        0, 1, 2, 1, 48, 1, 2, 1, 48, 47, 1, 2, 47, 1, 2, 1, 2, 1, 48, 1, 2, 1, 1, 0,
        0, 2, 47, 2, 1, 2, 1, 2, 1, 2, 48, 1, 2, 1, 47, 2, 1, 47, 1, 2, 1, 48, 2, 0,
        0, 1, 2, 1, 2, 47, 48, 1, 2, 1, 2, 1, 48, 2, 1, 2, 1, 2, 1, 2, 47, 1, 1, 0,
        0, 48, 1, 2, 1, 2, 1, 47, 1, 2, 1, 47, 1, 2, 1, 2, 48, 1, 2, 1, 2, 1, 48, 0,
        0, 1, 2, 1, 2, 1, 2, 1, 2, 1, 2, 1, 2, 27,27,27,27,27, 28,28,28,28,28, 0,
        0, 2, 1, 48, 1, 47, 1, 2, 47, 1, 2, 1, 2, 27,27,27,27,27, 28,28,28,28,28, 0,
        0, 1, 2, 1, 2, 1, 2, 1, 2, 48, 1, 2, 1, 27,27,27,27,27, 28,28,28,28,28, 0,
        0, 47, 1, 2, 1, 2, 48, 1, 2, 1, 47, 1, 2, 27,27,27,27,27, 28,28,28,28,28, 0,
        0, 1, 2, 1, 48, 1, 2, 47, 1, 2, 1, 48, 1, 27,27,27,27,27, 28,28,28,28,28, 0,
        0, 2, 1, 2, 1, 2, 1, 2, 1, 2, 1, 2, 1, 27,27,27,27,27, 28,28,28,28,28, 0,
        0, 0, 0, 0, 0, 0, 0, 0, 0, 0, 0, 0, 0, 0, 0, 0, 0, 0, 0, 0, 0, 0, 0, 0
      ]
    },
    {
      "name": "walls",
      "type": "tiles",
      "data": [
        7, 5, 5, 5, 5, 5, 5, 5, 5, 5, 5, 5, 5, 5, 5, 5, 5, 5, 5, 5, 5, 5, 5, 8,
        6, 0, 0, 0, 0, 0, 0, 0, 0, 0, 0, 0, 0, 0, 0, 0, 0, 0, 0, 0, 0, 0, 0, 6,
        6, 0, 0, 0, 0, 0, 0, 0, 0, 0, 0, 0, 0, 0, 0, 0, 0, 0, 0, 0, 0, 0, 0, 6,
        6, 0, 0, 0, 0, 0, 0, 0, 0, 0, 0, 0, 0, 0, 0, 0, 0, 0, 0, 0, 0, 0, 0, 6,
        6, 0, 0, 0, 0, 0, 0, 0, 0, 0, 0, 0, 0, 0, 0, 0, 0, 0, 0, 0, 0, 0, 0, 6,
        6, 0, 0, 0, 0, 0, 0, 0, 0, 0, 0, 0, 0, 0, 0, 0, 0, 0, 0, 0, 0, 0, 0, 6,
        6, 0, 0, 0, 0, 0, 0, 0, 0, 0, 0, 0, 0, 0, 0, 0, 0, 0, 0, 0, 0, 0, 0, 6,
        6, 0, 0, 0, 0, 0, 0, 0, 0, 0, 0, 0, 0, 0, 0, 0, 0, 0, 0, 0, 0, 0, 0, 6,
        6, 0, 0, 0, 0, 0, 0, 0, 0, 0, 0, 0, 0, 0, 0, 0, 0, 0, 0, 0, 0, 0, 0, 6,
        6, 0, 0, 0, 0, 0, 0, 0, 0, 0, 0, 0, 0, 0, 0, 0, 0, 0, 0, 0, 0, 0, 0, 6,
        6, 0, 0, 0, 0, 0, 0, 0, 0, 0, 0, 0, 0, 0, 0, 0, 0, 0, 0, 0, 0, 0, 0, 6,
        6, 0, 0, 0, 0, 0, 0, 0, 0, 0, 0, 0, 0, 0, 0, 0, 0, 0, 0, 0, 0, 0, 0, 6,
        6, 0, 0, 0, 0, 0, 0, 0, 0, 0, 0, 0, 0, 0, 0, 0, 0, 0, 0, 0, 0, 0, 0, 6,
        6, 0, 0, 0, 0, 0, 0, 0, 0, 0, 0, 0, 0, 0, 0, 0, 0, 0, 0, 0, 0, 0, 0, 6,
        6, 0, 0, 0, 0, 0, 0, 0, 0, 0, 0, 0, 0, 0, 0, 0, 0, 0, 0, 0, 0, 0, 0, 6,
        6, 0, 0, 0, 0, 0, 0, 0, 0, 0, 0, 0, 0, 0, 0, 0, 0, 0, 0, 0, 0, 0, 0, 6,
        6, 0, 0, 0, 0, 0, 0, 0, 0, 0, 0, 0, 0, 0, 0, 0, 0, 0, 0, 0, 0, 0, 0, 6,
        0, 9, 9, 9, 9, 9, 9, 9, 9, 9, 9, 9, 9, 9, 9, 9, 9, 9, 9, 9, 9, 9, 9, 0
      ]
    },
    {
      "name": "furniture",
      "type": "tiles",
      "data": [
        0, 0, 0, 0, 0, 0, 0, 0, 0, 0, 0, 0, 0, 0, 0, 0, 0, 0, 0, 0, 0, 0, 0, 0,
        0, 0,22,23, 0,29, 0, 0,29, 0, 0,29, 0, 0, 0,22,23, 0, 0, 0,24,25, 0, 0,
        0, 0, 0, 0, 0, 0, 0, 0, 0, 0, 0, 0, 0, 0, 0, 0, 0, 0, 0, 0, 0, 0, 0, 0,
        0, 0,43,44, 0,43,44, 0,43,44, 0,43,44, 0, 0, 0, 0, 0, 0, 0, 0, 0, 0, 0,
        0, 0,45, 0, 0,45, 0, 0,46, 0, 0,45, 0, 0, 0, 0, 0, 0,51, 0, 0, 0, 0, 0,
        0, 0, 0, 0, 0, 0, 0, 0, 0, 0, 0, 0, 0, 0, 0, 0, 0, 0, 0, 0, 0, 0, 0, 0,
        0, 0,43,44, 0,43,44, 0,43,44, 0,43,44, 0, 0, 0, 0, 0, 0,50, 0, 0, 0, 0,
        0, 0,46, 0, 0,45, 0, 0,45, 0, 0,46, 0, 0, 0, 0, 0, 0, 0, 0, 0, 0, 0, 0,
        0, 0, 0, 0, 0, 0, 0, 0, 0, 0, 0, 0, 0, 0, 0, 0, 0, 0, 0, 0, 0, 0, 0, 0,
        0,49, 0, 0, 0, 0, 0, 0, 0, 0, 0, 0, 0, 0,26, 0, 0, 0, 0, 0, 0,53, 0, 0,
        0, 0, 0, 0, 0, 0, 0, 0, 0, 0, 0,49, 0, 0, 0, 0, 0, 0, 0, 0, 0, 0, 0, 0,
        0, 0, 0, 0, 0, 0, 0, 0, 0, 0, 0, 0, 0, 0, 0, 0, 0, 0, 0, 0, 0,49, 0, 0,
        0, 0, 0, 0, 0, 0, 0, 0, 0, 0, 0, 0, 0,36, 0,36, 0, 0,18,19,19,20, 0, 0,
        0, 0, 0, 0, 0, 0, 0, 0, 0,49, 0, 0, 0,34,35,34,35, 0, 0,21, 0, 0, 0, 0,
        0, 0, 0, 0, 0, 0, 0, 0, 0, 0, 0, 0, 0,37, 0,37, 0, 0,18,19,19,20, 0, 0,
        0, 0, 0, 0, 0, 0, 0, 0, 0, 0, 0, 0, 0, 0, 0, 0, 0, 0, 0, 0, 0, 0, 0, 0,
        0, 0, 0, 0, 0, 0, 0, 0, 0, 0, 0, 0, 0, 0, 0, 0, 0, 0, 0, 0, 0, 0, 0, 0,
        0, 0, 0, 0, 0, 0, 0, 0, 0, 0, 0, 0, 0, 0, 0, 0, 0, 0, 0, 0, 0, 0, 0, 0
      ]
    }
  ],
  "zones": [
    { "name": "meeting", "label": "Sala de Reuniones", "x": 13, "y": 11, "w": 5, "h": 6, "tileX": 13, "tileY": 11 },
    { "name": "break", "label": "Zona de Descanso", "x": 18, "y": 11, "w": 5, "h": 6, "tileX": 18, "tileY": 11 },
    { "name": "bathroom", "label": "Lavabo", "x": 19, "y": 1, "w": 4, "h": 3, "tileX": 19, "tileY": 1 }
  ],
  "desks": [
    { "x": 2, "y": 3, "index": 0 },
    { "x": 5, "y": 3, "index": 1 },
    { "x": 8, "y": 3, "index": 2 },
    { "x": 11, "y": 3, "index": 3 },
    { "x": 2, "y": 6, "index": 4 },
    { "x": 5, "y": 6, "index": 5 },
    { "x": 8, "y": 6, "index": 6 },
    { "x": 11, "y": 6, "index": 7 }
  ],
  "collisions": [5, 6, 7, 8, 9, 10, 11, 12, 13, 22, 23, 24, 25, 26, 34, 35, 38, 39, 43, 44, 50, 51]
}
